name=Two Targets
difficulty=Medium
########
#   .  #
# $$   #
#  @ . #
#      #
########
