name=Corner Push
difficulty=Easy
########
#  .   #
#  $@  #
#      #
########
