name=Narrow Hall
difficulty=Medium
######
#    #
#  # ###
# .$   #
# .$ @ #
########
