name=Warm Up
#######
#     #
# .$  #
#  @  #
#     #
#######
