name=Box Trap
difficulty=Hard
#######
# .   #
#  $  #
# .$$@#
#  .  #
#######
